2 2 2 2 2 2 2 2 2 2 2 2 2 2 2 2 2 2 2 2 2 2 2 2 2 2 2 2 2 2 2 2 2 2 2 2 2 2 2 2 2 2 2 2 2 2 2 2 2 2
2 2 2 2 2 2 2 2 2 2 2 2 2 2 2 2 2 2 2 2 2 2 2 2 2 2 2 2 2 2 2 2 2 2 2 2 2 2 2 2 2 2 2 2 2 2 2 2 2 2
2 2 0 0 0 0 0 0 0 0 0 0 0 0 0 0 0 0 0 0 0 0 5 5 5 5 5 0 0 0 0 0 0 0 0 0 0 0 0 0 0 0 0 0 0 0 0 0 2 2
2 2 0 5 5 5 5 5 5 5 5 5 5 5 5 5 5 0 0 0 0 0 5 4 4 4 5 0 0 0 0 0 0 5 5 5 5 5 5 5 5 5 5 5 5 5 5 0 2 2 
2 2 0 5 5 5 5 5 5 5 5 5 5 5 5 5 0 0 0 0 0 0 5 4 4 4 5 0 0 0 0 0 0 0 5 5 5 5 5 5 5 5 5 5 5 5 5 0 2 2
2 2 0 5 5 5 5 5 5 5 5 5 5 5 5 5 0 0 0 0 0 0 5 4 4 4 5 0 0 0 0 0 0 0 5 5 5 5 5 5 5 5 5 5 5 5 5 0 2 2
2 2 0 5 5 5 5 5 5 5 5 5 5 5 5 5 0 0 0 0 0 0 5 4 4 4 5 0 0 0 0 0 0 0 5 5 5 5 5 5 5 5 5 5 5 5 5 0 2 2
2 2 0 5 5 5 5 5 5 5 5 5 5 5 0 0 0 0 0 0 0 0 5 4 4 4 5 0 0 0 0 0 0 0 0 0 5 5 5 5 5 5 5 5 5 5 5 0 2 2
2 2 0 5 5 5 5 5 5 5 5 0 0 0 0 0 0 0 0 0 0 0 5 4 4 4 5 0 0 0 0 0 0 0 0 0 0 0 0 5 5 5 5 5 5 5 5 0 2 2
2 2 0 5 5 5 5 5 0 0 0 0 0 0 0 0 0 0 0 0 0 0 5 4 4 4 5 0 0 0 0 0 0 0 0 0 0 0 0 0 0 0 5 5 5 5 5 0 2 2
2 2 0 5 5 5 5 5 0 0 0 0 0 0 0 0 0 0 0 0 0 0 5 4 4 4 5 0 0 0 0 0 0 0 0 0 0 0 0 0 0 0 5 5 5 5 5 0 2 2
2 2 0 5 5 5 5 5 0 0 0 0 0 0 0 0 0 0 0 0 0 0 5 4 4 4 5 0 0 0 0 0 0 0 0 0 0 0 0 0 0 0 5 5 5 5 5 0 2 2
2 2 0 5 5 5 5 5 0 0 0 0 0 0 0 0 0 0 0 0 0 0 5 4 4 4 5 0 0 0 0 0 0 0 0 0 0 0 0 0 0 0 5 5 5 5 5 0 2 2
2 2 0 5 5 5 5 5 0 0 0 0 0 0 0 0 0 0 0 0 0 0 5 4 4 4 5 0 0 0 0 0 0 0 0 0 0 0 0 0 0 0 5 5 5 5 5 0 2 2
2 2 0 5 5 5 5 5 0 0 0 0 0 0 0 0 0 0 0 0 0 0 5 4 4 4 5 0 0 0 0 0 0 0 0 0 0 0 0 0 0 0 5 5 5 5 5 0 2 2 
2 2 0 5 5 5 5 5 0 0 0 0 0 0 0 0 0 0 0 0 0 0 5 4 4 4 5 0 0 0 0 0 0 0 0 0 0 0 0 0 0 0 5 5 5 5 5 0 2 2
2 2 0 5 5 5 5 5 0 0 0 0 0 0 0 0 0 0 0 0 0 0 5 4 4 4 5 0 0 0 0 0 0 0 0 0 0 0 0 0 0 0 5 5 5 5 5 0 2 2
2 2 0 5 5 5 5 5 0 0 0 0 0 0 0 0 0 0 0 0 0 0 5 4 4 4 5 0 0 0 0 0 0 0 0 0 0 0 0 0 0 0 5 5 5 5 5 0 2 2
2 2 0 5 5 5 5 5 0 0 0 0 0 0 0 0 0 0 0 0 0 0 5 4 4 4 5 0 0 0 0 0 0 0 0 0 0 0 0 0 0 0 5 5 5 5 5 0 2 2
2 2 0 5 5 5 5 5 0 0 0 0 0 0 0 0 0 0 0 0 0 0 5 4 4 4 5 0 0 0 0 0 0 0 0 0 0 0 0 0 0 0 5 5 5 5 5 0 2 2
2 2 0 5 5 5 5 5 0 0 0 0 0 0 0 0 0 0 0 0 0 0 5 4 4 4 5 0 0 0 0 0 0 0 0 0 0 0 0 0 0 0 5 5 5 5 5 0 2 2
2 2 0 5 5 5 5 5 0 0 0 0 0 0 0 0 0 0 0 0 0 0 5 4 4 4 5 0 0 0 0 0 0 0 0 0 0 0 0 0 0 0 5 5 5 5 5 0 2 2
2 2 2 2 2 2 2 2 2 2 2 2 2 2 2 2 2 2 2 2 2 2 2 4 4 4 2 2 2 2 2 2 2 2 2 2 2 2 2 2 2 2 2 2 2 2 2 2 2 2
2 2 0 4 4 4 4 4 4 4 4 4 4 4 4 4 4 4 4 4 4 4 4 4 4 4 4 4 4 4 4 4 4 4 4 4 4 4 4 4 4 4 4 4 4 4 4 0 2 2 
2 2 0 4 4 4 4 4 4 4 4 4 4 4 4 4 4 4 4 4 4 4 4 4 4 4 4 4 4 4 4 4 4 4 4 4 4 4 4 4 4 4 4 4 4 4 4 0 2 2 
2 2 0 4 4 4 4 4 4 4 4 4 4 4 4 4 4 4 4 4 4 4 4 4 4 4 4 4 4 4 4 4 4 4 4 4 4 4 4 4 4 4 4 4 4 4 4 0 2 2 
2 2 2 2 2 2 2 2 2 2 2 2 2 2 2 2 2 2 2 2 2 2 2 4 4 4 2 2 2 2 2 2 2 2 2 2 2 2 2 2 2 2 2 2 2 2 2 2 2 2
2 2 0 5 5 5 5 5 0 0 0 0 0 0 0 0 0 0 0 0 0 0 5 4 4 4 5 0 0 0 0 0 0 0 0 0 0 0 0 0 0 0 5 5 5 5 5 0 2 2
2 2 0 5 5 5 5 5 0 0 0 0 0 0 0 0 0 0 0 0 0 0 5 4 4 4 5 0 0 0 0 0 0 0 0 0 0 0 0 0 0 0 5 5 5 5 5 0 2 2
2 2 0 5 5 5 5 5 0 0 0 0 0 0 0 0 0 0 0 0 0 0 5 4 4 4 5 0 0 0 0 0 0 0 0 0 0 0 0 0 0 0 5 5 5 5 5 0 2 2
2 2 0 5 5 5 5 5 0 0 0 0 0 0 0 0 0 0 0 0 0 0 5 4 4 4 5 0 0 0 0 0 0 0 0 0 0 0 0 0 0 0 5 5 5 5 5 0 2 2
2 2 0 5 5 5 5 5 0 0 0 0 0 0 0 0 0 0 0 0 0 0 5 4 4 4 5 0 0 0 0 0 0 0 0 0 0 0 0 0 0 0 5 5 5 5 5 0 2 2
2 2 0 5 5 5 5 5 0 0 0 0 0 0 0 0 0 0 0 0 0 0 5 4 4 4 5 0 0 0 0 0 0 0 0 0 0 0 0 0 0 0 5 5 5 5 5 0 2 2
2 2 0 5 5 5 5 5 0 0 0 0 0 0 0 0 0 0 0 0 0 0 5 4 4 4 5 0 0 0 0 0 0 0 0 0 0 0 0 0 0 0 5 5 5 5 5 0 2 2
2 2 0 5 5 5 5 5 5 5 5 5 5 5 5 5 5 0 0 0 0 0 5 4 4 4 5 0 0 0 0 0 0 5 5 5 5 5 5 5 5 5 5 5 5 5 5 0 2 2 
2 2 5 5 5 5 5 5 5 5 5 5 5 5 5 5 0 0 0 0 0 0 5 4 4 4 5 0 0 0 0 0 0 0 5 5 5 5 5 5 5 5 5 5 5 5 5 0 2 2
2 2 5 5 5 5 5 5 5 5 5 5 5 5 5 5 0 0 0 0 0 0 5 4 4 4 5 0 0 0 0 0 0 0 5 5 5 5 5 5 5 5 5 5 5 5 5 0 2 2
2 2 5 5 5 5 5 5 5 5 5 5 5 5 5 5 0 0 2 2 2 2 2 4 4 4 2 2 2 2 2 0 0 0 5 5 5 5 5 5 5 5 5 5 5 5 5 0 2 2
2 2 5 5 5 5 5 5 5 5 5 5 5 5 0 0 0 0 2 2 2 2 2 4 4 4 2 2 2 2 2 0 0 0 0 0 5 5 5 5 5 5 5 5 5 5 5 0 2 2
2 2 5 5 5 5 5 5 5 5 5 0 0 0 0 0 0 0 2 2 2 2 2 4 4 4 2 2 2 2 2 0 0 0 0 0 0 0 0 5 5 5 5 5 5 5 5 0 2 2
2 2 5 5 2 2 2 2 2 2 2 2 2 0 0 0 0 0 2 2 2 2 2 4 4 4 2 2 2 2 2 0 0 0 0 0 0 0 0 0 0 0 5 5 5 5 5 0 2 2
2 2 5 5 1 1 1 1 1 1 1 1 1 1 1 1 1 1 1 1 1 1 1 3 3 3 1 1 1 1 1 1 1 1 1 1 1 1 1 1 1 1 1 1 1 1 1 0 2 2 
2 2 5 5 1 3 3 3 3 3 3 3 3 3 3 3 3 3 3 3 3 3 3 3 3 3 3 3 3 3 3 3 3 3 3 3 3 3 3 3 3 3 3 3 3 3 1 0 2 2
2 2 5 5 1 3 3 3 3 3 3 3 3 3 3 3 3 3 3 3 3 3 3 3 3 3 3 3 3 3 3 3 3 3 3 3 3 3 3 3 3 3 3 3 3 3 1 0 2 2
2 2 5 5 1 3 3 3 3 3 3 3 3 3 3 3 3 3 3 3 3 3 3 3 3 3 3 3 3 3 3 3 3 3 3 3 3 3 3 3 3 3 3 3 3 3 1 0 2 2
2 2 5 5 1 3 3 3 3 3 3 3 3 3 3 3 3 3 3 3 3 3 3 3 3 3 3 3 3 3 3 3 3 3 3 3 3 3 3 3 3 3 3 3 3 3 1 0 2 2
2 2 2 2 1 1 1 1 1 1 1 1 1 1 1 1 1 1 1 1 1 1 1 1 1 1 1 1 1 1 1 1 1 1 1 1 1 1 1 1 1 1 1 1 1 1 1 1 1 1
2 2 2 2 2 2 2 2 2 2 2 2 2 5 5 5 5 5 5 5 5 5 5 5 5 5 5 5 5 5 5 5 5 5 2 2 2 2 2 2 2 2 2 2 2 2 2 2 2 2
2 2 2 2 2 2 2 2 2 2 2 2 2 2 2 2 2 2 2 2 2 2 2 2 2 2 2 2 2 2 2 2 2 2 2 2 2 2 2 2 2 2 2 2 2 2 2 2 2 2
2 2 2 2 2 2 2 2 2 2 2 2 2 2 2 2 2 2 2 2 2 2 2 2 2 2 2 2 2 2 2 2 2 2 2 2 2 2 2 2 2 2 2 2 2 2 2 2 2 2